11111111111111111111111111111111
1000000000111111001C100000000001
110000100P00C0000000011111000001
11100000001100000001100000000001
1111111E111111110000100000001101
10000001000000000000100000001101
11111111111111100001100000001011
11111111111111100001100000001011
11111111111111100001100000001011
10000000000000000111111100011111
11111111111111111111111111111111